15.oX
..........ooo.....o.....o.....
..o..............o............
.........o....................
.o.......o....................
.....o.....o...........o..o...
.o.....o...o............o.....
......o.......................
.....o...........o..oo.......o
o.............................
..o.o...o......o.........o....
....o...................o.....
.....o.o..o.....o......o......
...o...................o..oo.o
..................o........o.o
....oo.....o.o....o...........
